1,1,1,1,1,1,1,1,1,1,1,1
x,x,x,x,x,x,x,x,x,x,x,x
1,1,1,1,1,1,1,1,1,1,1,1
x,x,x,x,x,x,x,x,x,x,x,x
1,1,1,1,1,1,1,1,1,1,1,1
x,x,x,x,x,x,x,x,x,x,x,x
7,7,7,7,7,7,7,7,7,7,7,7
x,x,x,x,x,x,x,x,x,x,x,x
x,x,x,x,x,x,x,x,x,x,x,x
x,x,x,x,x,x,x,x,x,x,x,x
x,x,x,x,x,x,x,x,x,x,x,x
